aacidexam	adexone	alin	ambene	amplidermis	antimicotico	aquapred	auricularum	auxiloson	azona	baycuten	corson	cortidexason	cortisumman	decacort	decadrol	decadron	decalix	decameth	dectancyl	deenar	dekacort	deltafluorene	deronil	desameton	dexace	dexacortal	dexacortin	dexafarma	dexafluorene	dexalocal	dexamecortin	dexameth	dexamethasone	dexamonozon	dexapos	dexinoral	dexone	dinormon	fluorodelta	fortecortin	gammacorten	hexadrol	loverine	millicorten	mymethasone	ocasa	orgadrone	spersadex	visumetazone	
aberel	airol	aknoten	avita	dermairol	eudyna	renova	tretinoin	vesanoid	vitinoin	
abetalipoproteinaemia	abetalipoproteinemia	
abiplatin	blastolem	briplatin	cisplatin	cisplatyl	citoplatino	citosin	diaminedichloroplatinum	lederplatin	metaplatin	neoplatin	placis	plastistil	platamine	platiblastin	platinex	platinol	platiran	platistin	platosin	
abitrexate	amethopterin	brimexate	emtexate	emthexat	emthexate	farmitrexat	fauldexato	folex	lantarel	ledertrexate	lumexon	maxtrex	medsatrexate	metex	methoblastin	methotrexate	metrotex	mexate	novatrex	rheumatrex	texate	tremetex	trexeron	trixilem	
abreva	docosanol	
absorbine	aftate	desenex	genaspor	tolnaftate	
acanthameba	acanthamoeba	
acanthamebiasis	acanthamoebiasis	
acantholyses	acantholysis	
acarbose	precose	
accure	accutane	amnesteem	cistane	claravis	isotretinoin	isotrex	isotrexin	oratane	roaccutan	roaccutane	roacutan	sotret	
accusite	adrucil	arumel	cytosafe	efudex	efurix	fiverocil	fluoroplex	fluorouracil	flurablastin	fluracedyl	fluracil	fluril	fluroblastin	flurox	ribofluor	timazin	
acecarbromal	acetylcarbromal	
acenocoumarol	nicoumalone	
acetadote	acetylcysteine	airbron	broncholysin	brunac	fabrol	fluatox	fluimucetin	fluimucil	fluprowit	mucocedyl	mucolator	mucolyticum	mucomyst	mucosolvin	mucret	parvolex	respaire	tixair	
acetaminophen	paracetamol	tylenol	
acetanilid	acetanilide	
acetazolamide	diacarb	diluran	
acetohexamide	dymelor	
acetophenetidin	phenacetin	
acetyltransferase	transacetylase	
acicloftal	aciclovir	aclovir	acycloguanosine	acyclovir	cargosil	virorax	zovirax	
acidoses	acidosis	
acitretin	neotigason	soriatane	
aclacin	aclacinomycine	aclacinon	aclaplastin	aclarubicin	jaclacin	
acnestrol	antigestil	apstil	boestrol	bufon	diastyl	diethylstilbestrol	diethylstilboestrol	distilbene	domestrol	estrobene	estrosyn	fonatol	grafestrol	makarol	microest	milestrol	oestrogenine	oestromenin	oestromensyl	oestromon	palestrol	serral	sexocretin	sibol	stilbestrol	stilbetin	stilboefral	stilboestroform	stilboestrol	stilkap	synestrin	synthoestrin	vagestrol	
acrivastine	semprex	
acrocephaly	oxycephaly	
acrodermatitides	acrodermatitis	
actigall	deursil	ursodiol	
actinobacilloses	actinobacillosis	
actinomycoses	actinomycosis	
activase	alteplase	
aczone	avlosulfon	dapsone	diaminodiphenylsulfone	diaminodiphenylsulphone	disulone	eporal	undolac	
adalat	nifedipine	procardia	
adapalene	differin	
adasone	cortancyl	dacortin	decortin	decortisyl	decorton	deltacortene	deltasone	deltison	deltra	econosone	lisacort	meticorten	ofisolona	orasone	panafcort	paracort	predeltin	predicor	predicorten	prednicort	prednidib	prednilonga	predniment	prednisone	prednitone	promifen	servisone	sterapred	
adenitides	adenitis	
adenohypophyses	adenohypophysis	
adenosylcobalamin	cobamamide	
adenoviridae	adenovirus	
adiposity	obesity	
adlone	depmedalone	duralone	emmetipi	esametone	firmacort	medrol	medrone	meprdl	meprolone	methylprednisolone	metrocort	metypresol	metysolon	prednilen	radilem	sieropresol	solpredone	summicort	urbason	wyacort	
adnisolone	aprednislon	capsoid	cortalone	cortisolone	decaprednil	deltacortril	deltahydrocortisone	deltasolone	deltidrosol	dhasolone	estilsona	fisopred	frisolona	gupisone	hydeltra	hydeltrasol	klismacort	kuhlprednon	lenisolone	longiprednil	meticortelone	opredsone	panafcortelone	precortisyl	predeltilone	prednicortelone	prednisolone	prelone	prenilone	
adrenaline	epinephrine	
adrenocorticotropin	corticotrophin	corticotropin	
adrenoleukodystrophy	adrenomyeloneuropathy	
adroyd	anadrol	anapolon	hemogenin	oxitosona	oxymetholone	plenastril	synasteron	
aerobioses	aerobiosis	
afibrinogenaemia	afibrinogenemia	
aflodac	algocetil	arthrocine	artribid	citireuma	clinoril	clisundac	imbaral	reumofil	reumyl	sudac	sulindac	sulinol	sulreuma	
agammaglobulinaemia	agammaglobulinemia	
aganon	ahanon	talastine	
ageing	aging	
agranulocytoses	agranulocytosis	
ala	alanine	
albendazole	albenza	zentel	
albuterol	salbutamol	
alcaptonuria	alkaptonuria	
alcobon	ancobon	ancotil	flucytosine	
alcohol	ethanol	
alcoholism	dipsomania	
aldara	imiquimod	
aldomet	amodopa	dopamet	methyldopa	
alendronate	fosamax	
alexan	arabine	arabinosylcytosine	aracytin	aracytine	cytarabine	cytarbel	cytosar	erpalfa	starasid	udicil	
alfacalcidol	hydroxycholecalciferol	
alimemazine	levomeprazine	levomepromazine	levoprome	methotrimeprazine	trimeprazine	
alinia	nitazoxanide	
alkali	base	
alkaloses	alkalosis	
alkene	olefin	
allantoin	cordianine	glyoxyldiureide	
allergy	hypersensitivity	
allescheriosis	petriellidosis	
alloin	aloin	
allylbarbital	butalbital	
allylestrenol	organon	
alprazolam	xanax	
alprostadil	caverject	
altace	ramipril	
altretamine	hexalen	hexamethylmelamine	hexastat	hexinawas	
aluminium	aluminum	
amaryl	glimepiride	
ambochlorin	amboclorin	chlorambucil	chloraminophene	leukeran	linfolysin	
amcinonide	cyclocort	
ameba	amoeba	
amebas	amoebida	
amebiases	amebiasis	amoebiases	amoebiasis	
amebicides	amoebicides	
ameboma	amoeboma	
amekrin	amsacrine	amsidine	amsidyl	lamasine	
amelogeneses	amelogenesis	
amenorrhea	amenorrhoea	
amethocaine	tetracaine	
amfebutamone	bupropion	
amfepramone	diethylpropion	
amfetamine	amphetamine	phenylaminopropane	
amfetamines	amphetamines	
amidate	etomidate	
amiloride	amipramizide	
aminacrine	aminoacridine	
aminobenzylpenicillin	ampicillin	
aminoblastin	aminoglutethimide	cytadren	mamomit	orimeten	orimetene	rodazol	
aminocyclohexylpenicillin	ciclacillin	cyclacillin	
aminophylline	phyllocontin	truphylline	
amlexanox	aphthasol	
ammoidin	deltasoralen	dermox	geralen	geroxalen	meladinina	meladinine	methoxsalen	methoxypsoralen	metoxaleno	mopsoralen	oxsoralen	puvasoralen	ultramop	uvadex	xanthotoxin	
amniocenteses	amniocentesis	
amnionitides	amnionitis	
amobarbital	amylobarbitone	
amodiaquin	amodiaquine	
amoxapine	asendin	
amoxicillin	amoxicilline	amoxil	amoxycillin	polymox	trimox	utimox	wymox	
ampligen	atvogen	
amplimexon	imexon	
amrinone	inamrinone	
amyloidoses	amyloidosis	
amylopectinoses	amylopectinosis	
anaemia	anemia	
anaerobioses	anaerobiosis	
anaesthetics	anesthetics	
analphaliproteinaemia	analphaliproteinemia	
analysers	analyzers	
anandron	nilandron	nilutamide	
anaplasmoses	anaplasmosis	
ancylostomiases	ancylostomiasis	
android	eldec	estratest	malogen	metandren	methyltestosterone	testomet	testovis	testred	
andromedotoxin	grayanotoxin	
androstanazol	stanozolol	winstrol	
androstenolone	dehydroepiandrosterone	dehydroisoandrosterone	fidelin	prasterone	
anencephalus	anencephaly	
anesthesin	benzocaine	chloraseptic	
anger	angry	
angiectasia	angiectasis	
angiitides	angiitis	arteritides	arteritis	vasculitides	vasculitis	
angina	stenocardia	
angiomatoses	angiomatosis	
angiomax	bivalirudin	
angiopeptin	lanreotide	
anguilluliases	anguilluliasis	
anisakiases	anisakiasis	
anisindione	miradon	
ankyloses	ankylosis	
anorexiant	anorexics	
ansaid	flurbiprofen	
anspor	cefradine	cephradine	velosef	
antabuse	disulfiram	disulphiram	
anthelmintic	filaricides	
anthracoses	anthracosis	
anthracosilicoses	anthracosilicosis	
anthralin	dithranol	
anthraquinone	morkit	
antibioses	antibiosis	
antipyrine	phenazone	
antisedan	atipamezole	
antizol	fomepizole	
antrapurol	chrysazin	danthron	dantron	
anturane	sulfinpyrazone	sulphinpyrazone	
anzatax	asotax	bristaxol	paclitaxel	praxel	taxol	
aortitides	aortitis	
apathy	indifference	listless	
apaziquone	eoquin	neoquin	
apazone	azapropazone	
aphereses	apheresis	
apimid	chimax	drogenil	euflex	eulexin	eulexine	flucinome	fluken	flulem	flutabene	flutacan	flutamex	flutamide	flutamin	flutan	flutaplex	fugerel	grisetin	oncosal	profamid	prostacur	prostadirex	prostica	prostogenat	tafenil	tecnoflut	testotard	
aplodan	creatinolfosfate	
apnea	apnoea	
appendectomy	appendicectomy	
apraxia	clumsiness	
apressinum	hydralazine	
aprotinin	trasylol	
aptosyn	exisulind	
aptyalism	xerostomia	
aquatensen	enduron	methyclothiazide	
arabidopses	arabidopsis	
arabinofuranosyladenine	vidarabine	
arachnoiditides	arachnoiditis	
arava	leflunomide	
archaeologist	archeologist	
arg	arginine	
argilla	kaolin	
aristocort	triamcinolone	
arkin	vesnarinone	
arterioscleroses	arteriosclerosis	
arthritides	arthritis	
arthrodeses	arthrodesis	
arthrogryposes	arthrogryposis	
arylsulfatase	arylsulphatase	
asacol	fisalamine	mesalamine	mesalazine	pentasa	rowasa	
asbestoses	asbestosis	
ascariases	ascariasis	
ascaridiases	ascaridiasis	
asercit	dacarbazine	dacatic	deticene	detimedac	fauldetic	
asn	asparagine	
asp	aspartate	
asparaginase	elspar	kidrolase	laspar	leucogen	leunase	paronal	
aspergilloses	aspergillosis	
aspergum	aspirin	ecotrin	empirin	entericin	extren	measurin	
asphyxia	asphyxiation	suffocation	
aspiculariases	aspiculariasis	
astemizole	hismanal	
atamir	cuprenil	cuprimine	cupripen	depen	distamine	kelatin	mercaptyl	metalcaptase	pendramine	penicillamine	perdolat	sufortan	trolovol	
atarax	hydroxyzine	vistaril	
atelectases	atelectasis	
atheroscleroses	atherosclerosis	
athetoses	athetosis	
ativan	lorazepam	
atomiser	atomizer	
atovaquone	mepron	
atropine	daturine	
auscultation	listening	
ausobronc	filesna	mesna	mesnex	mesnil	mexan	mistabron	mistabronco	mitexan	mucofluid	mucolene	uromitexan	ziken	
autoanalyses	autoanalysis	
autolyses	autolysis	
axid	nizatidine	
axon	axone	
azacitidine	azacytidine	ladakamycin	mylosar	vidaza	
azactam	azthreonam	aztreonam	
azidothymidine	aztec	retrovir	zidovudine	
azithromycin	zithromax	
azlin	azlocillin	
azolastone	mitozolomide	
azulfidine	salazosulfapyridine	salazosulphapyridine	salicylazosulfapyridine	salicylazosulphapyridine	sulfasalazine	sulphasalazine	
babesiases	babesiasis	
babesioses	babesiosis	
baclofen	lioresal	
bacteraemia	bacteremia	
bacteriolyses	bacteriolysis	
balanitides	balanitis	
balantidiases	balantidiasis	
banisterine	harmine	
bartonelloses	bartonellosis	
batroxobin	defibrase	
bavistin	carbendazim	derosal	
becenum	becenun	bicnu	carmubris	carmustine	carmustinum	gliadel	nitrourean	nitrumon	
beclometasone	beclomethasone	
behavior	behaviour	
belch	burp	eructation	flatulence	flatus	gas	
belching	burping	
belustin	belustine	cecenu	ceenu	citostal	lomeblastin	lomustine	lucostin	lucostine	prava	
bendopa	cidandopa	deadopa	dopaflex	dopaidan	dopal	dopalina	dopar	doparkine	doparl	dopasol	dopaston	dopastral	doprin	eldopal	eldopar	eldopatec	eurodopa	laradopa	larodopa	ledopa	levodopa	levopa	maipedopa	parda	veldopa	
bendrofluazide	bendroflumethiazide	benzydroflumethiazide	naturetin	
benemid	probenecid	
benetazon	tribuzone	
benoquin	monobenzone	
benorilate	benorylate	
benoxinate	oxybuprocaine	
benzatropine	benztropine	
benzfetamine	benzphetamine	
benzhexol	trihexyphenidyl	
benznidazole	radanil	
benzonatate	tessalon	
benzosulfimide	benzosulphimide	saccharin	
benzothiazide	benzthiazide	
benzoxazocine	nefopam	
bertielliases	bertielliasis	
beryllioses	berylliosis	
besnoitiases	besnoitiasis	
besnoitioses	besnoitiosis	
bestiality	zoophilia	
betaine	lycine	oxyneurine	
betamethasone	celestone	
betanidine	bethanidine	
betimol	timolol	
biaxin	clarithromycin	
bigonist	buserelin	etilamide	profact	receptal	suprecur	suprefact	
bilharziases	bilharziasis	
biltricide	praziquantel	
biogeneses	biogenesis	
bioprostheses	bioprosthesis	
biphosphonate	bisphosphonate	diphosphonate	
bishydroxycoumarin	dicoumarol	dicumarol	
bistropamide	mydral	mydriacyl	opticyl	tropicacyl	tropicamide	
blastocarb	carboplat	carboplatin	carbosin	carbosol	carbotec	displata	ercar	nealorin	novoplatinum	paraplat	paraplatin	paraplatine	platinwas	ribocarbo	
blastomycoses	blastomycosis	
bleeding	haemorrhage	hemorrhage	
blepharitides	blepharitis	
blepharophimoses	blepharophimosis	
blepharoptoses	blepharoptosis	
blepharorrhaphy	tarsorrhaphy	
blow	cocaine	coke	crack	flake	snow	
bonzol	chronogyn	cyclomen	danazol	danocrine	danol	danoval	ladogal	winobanin	
breathless	breathlessness	
bromazine	bromodiphenhydramine	
bromelains	bromelin	
bromocriptine	bromocryptine	
bromodeoxyuridine	broxine	neomark	
bromosulfophthalein	bromosulphophthalein	sulfobromophthalein	sulphobromophthalein	
brompheniramine	parabromdylamine	
bronchi	bronchus	
bronchiectases	bronchiectasis	
bronchiolitides	bronchiolitis	
bronchitides	bronchitis	
bronchopneumonia	pneumonia	
bropirimine	remisar	
brucelloses	brucellosis	
bruise	bruises	contusion	ecchymoses	ecchymosis	haematoma	hematoma	
budecort	budesonide	butacort	eltair	nasocort	preferid	pulmicort	rhinocort	
bufotenin	bufotenine	
bumetanide	bumex	
bunostomiases	bunostomiasis	
buphenine	nylidrin	
bursitides	bursitis	
busulfan	busulfex	busulphan	mielucin	misulban	mitosan	myleran	
butabarbital	butabarbitone	secbutabarbital	
butethal	butobarbital	butobarbitone	
byssinoses	byssinosis	
ca	calcium	
cabergoline	dostinex	
cachectic	cachexia	
caecopexy	cecofixation	cecopexy	
caecostomy	cecostomy	
caecotomy	cecotomy	
caecum	cecum	
caenorhabditides	caenorhabditis	
cafda	clofarabine	clolar	
calcidiol	calcifediol	
calciferol	deltalin	drisdol	ergocalciferol	
calcinoses	calcinosis	
calcipotriene	calcipotriol	dovonex	
calculi	calculus	
calculoses	calculosis	
calusterone	methosarb	
camel	camelus	
camila	errin	ethinylnortestosterone	micronor	norethindrone	norethisterone	norlutin	
camp	tocladesine	
canaliculodacryocystorhinostomy	canaliculodcr	
cancer	malignancy	neoplasms	
candidiases	candidiasis	
cantor	minaprine	
capitrol	chloroxine	
capoten	captopril	
carafate	sucralfate	
carbacefaclor	lorabid	loracarbef	
carbachol	carbacholine	carbastat	carboptic	miostat	
carbamazepine	epitol	tegretol	
carbamide	lanaphilic	nutraplus	urea	ureaphil	vanamide	
carbarson	carbarsone	
carbenicillin	geopen	pyopen	
carbetapentane	pentoxyverine	
carbidopa	lodosyn	
carbocisteine	carbocysteine	
carbohydrates	carbs	
carboxyhaemoglobin	carboxyhemoglobin	
carboxymethylcellulose	carmellose	
carisoprodate	carisoprodol	isobamate	isopropylmeprobamate	soma	
carloxan	cicloxal	clafen	cycloblastin	cycloblastine	cyclophosphamide	cyclostin	cyclostine	cytophosphan	fosfaseron	genoxal	genuxal	ledoxina	neosar	
carnitine	carnitor	levocarnitine	
carotenaemia	carotenemia	hypercarotinaemia	hypercarotinemia	
carvedilol	coreg	
catalyses	catalysis	
catharses	catharsis	
cathartic	purgative	
cauterisation	cauterization	
cauterise	cauterize	
cefadroxil	duricef	
cefalexin	cephalexin	keflex	
cefalotin	cephalothin	
cefamandole	cephamandole	
cefapirin	cephapirin	
cefazolin	cephazolin	
cefixime	suprax	
cefotaxime	claforan	
celontin	mesuximide	methsuximide	
cenuriases	cenuriasis	
cephalhaematoma	cephalhematoma	
cephalohaematoma	cephalohematoma	
cephulac	chronulac	lactulose	
cerazette	desogestrel	
cerebid	cerespan	papaverine	pavabid	pavacap	pavatym	
cerebromeningitides	cerebromeningitis	
cervicitides	cervicitis	
cervidil	dinoprostone	prepidil	
cesamet	nabilone	
chalk	crystal	desoxyephedrine	glass	ice	metamfetamine	meth	methamphetamine	speed	tina	
cheilitides	cheilitis	
chemet	succimer	
chemonucleolyses	chemonucleolysis	
chickenpox	varicella	
child	children	
chill	shivering	
chloasma	melasma	
chlophedianol	clofedanol	
chloral	trichloroacetaldehyde	
chloramiphene	clomifene	clomiphene	
chlorazepate	clorazepate	
chlorbutol	chlorobutanol	
chlordecone	kepone	
chlordiazepoxide	libritabs	
chlorguanide	chloroguanide	proguanil	
chlorhydroxyquinoline	halquinol	
chlorimipramine	clomipramine	
chlorine	cl	
chlormethazanone	chlormezanone	
chlormethiazole	clomethiazole	
chlormethine	mechlorethamine	mustine	
chloroform	trichloromethane	
chloroiodoquine	clioquinol	cloquinol	iodochlorhydroxyquin	
chloropyrilene	chlorothen	
chloroses	chlorosis	
chlorothiazide	diuril	
chloroxylenol	parachlorometaxylenol	
chlorphenamine	chlorpheniramine	
chlorpromazine	thorazine	
chlorpropamide	diabinese	
chlorquinaldol	clorquinaldol	
chlortalidone	chlorthalidone	hygroton	thalitone	
chlorzoxazone	chlorzoxozone	paraflex	
cholangitides	cholangitis	
cholecalciferol	colecalciferol	
cholecystenterostomy	cholecystoenterostomy	
choledyl	cholinophyllin	oxtriphylline	
cholelithiases	cholelithiasis	gallstone	
cholestases	cholestasis	
cholesterol	hypercholesterolaemia	hypercholesterolemia	hyperlipidaemia	hyperlipidemia	hyperlipoproteinemia	
cholestyramine	cholybar	colestyramine	questran	
chorioamnionitides	chorioamnionitis	
chorioretinitides	chorioretinitis	
choroiditides	choroiditis	
chromelin	dihydroxyacetone	
chromoblastomycoses	chromoblastomycosis	chromomycoses	chromomycosis	
ciclosporin	csa	cyclosporin	cyclosporine	cyclosporines	neoral	sandimmun	sandimmune	sangcya	
cilostazol	pletal	
cimetidine	tagamet	
cimex	cimices	
cinchocaine	dibucaine	
cineole	eucalyptol	
cipro	ciprofloxacin	
cisapride	propulsid	
citalopram	citralopram	
citofur	coparogin	exonal	fental	florafur	fluorofur	ftorafur	ftoral	ftoralon	fulaid	fulfeel	furafluor	furofutran	futraful	lamar	lifril	neberk	nitobanil	riol	sinoflurol	sunfural	tefsiel	tegafur	utefos	
citrucel	methylcellulose	
citrullinaemia	citrullinemia	
cladribine	leustat	leustatin	leustatine	
claritin	loratadine	
clemastine	meclastine	
cleocin	clindamicin	clindamycin	
clo	hypochlorite	
clofazimine	lamprene	
clonorchiases	clonorchiasis	
clothes	garments	
clotrimazole	lotrimin	mycelex	
co	cobalt	
cocarcinogeneses	cocarcinogenesis	
coccidioidomycoses	coccidioidomycosis	
coccidioses	coccidiosis	
codeine	methylmorphine	
coenuriases	coenuriasis	
colitides	colitis	
collagenase	santyl	
colofixation	colopexy	
colors	colours	
colpoceliocentesis	culdocentesis	
communicatingact	communication	
comtan	entacapone	
conjunctivitides	conjunctivitis	
contergan	distaval	kevadon	neurosedyn	pantosediv	sedalis	softenon	synovir	talimol	thalidomide	thalomid	
convulsions	seizure	
copper	cu	
cordocenteses	cordocentesis	
cordran	fludroxycortide	flurandrenolide	flurandrenolone	
corgard	nadolol	
cortexone	deoxycorticosterone	deoxycortone	desoxycorticosterone	
corticosteroids	glucocorticoids	steroids	
cortisol	hydrocortisone	
cosmegen	dactinomycin	
cosyntropin	tetracosactide	tetracosactin	tetracosactrin	
cotton	gossypium	
counseling	counselling	
coxarthroses	coxarthrosis	
craniorachischises	craniorachischisis	
cryoglobulinaemia	cryoglobulinemia	
crypto	cryptosporidioses	cryptosporidiosis	
cryptococcoses	cryptococcosis	
crystodigin	digitoxin	
cubicin	daptomycin	
cuivasil	duncaine	leostesin	lidocaine	lidothesin	lignocaine	rucaina	
culex	culices	
curretab	medroxyprogesterone	
cyanoses	cyanosis	
cyclandelate	cyclospasmol	
cyclobarbital	cyclobarbitone	
cyclonamine	etamsylate	ethamsylate	
cycloserine	seromycin	
cylert	pemoline	phenylisohydantoin	
cymevan	ganciclovir	nordeoxyguanosine	virgan	
cys	cysteine	
cysteamine	mercaptamine	
cysticercoses	cysticercosis	
cystinoses	cystinosis	
cystitides	cystitis	
cystocele	cystocoele	
cytaphereses	cytapheresis	
cytokineses	cytokinesis	
cytotec	misoprostol	
dacogen	decitabine	
dacotin	dacplat	eloxatin	eloxatine	oxaliplatin	
dacryoadenitides	dacryoadenitis	
dacryocystitides	dacryocystitis	
daraprim	pyrimethamine	
daypro	oxaprozin	
daytrana	methylphenidate	
dc	deoxycytidine	
dda	dideoxyadenosine	
ddc	hivid	zalcitabine	
ddi	didanosine	dideoxyinosine	videx	
deanol	dimethylethanolamine	
debrisoquin	debrisoquine	isocaramidine	
decapeptyl	triptorelin	
decortilen	prednylidene	
deet	diethyltoluamide	
defaecation	defecation	
deferoxamine	deferrioxamine	desferrioxamine	
deglutition	swallowing	
degranol	mannomustine	
demeclocycline	demethylchlortetracycline	
dendrid	herplex	idexur	idoxene	idoxuridine	idulea	iduridin	iudr	kerecid	stoxil	virudox	
dentinogeneses	dentinogenesis	
deoxycoformycin	nipent	pentostatin	
deoxyribonuclease	deoxyribonucleases	desoxyribonuclease	
depakote	divalproex	
depersonalisation	depersonalization	
dephosphin	dynamin	
dermatitides	dermatitis	eczema	rashes	
dermatolyses	dermatolysis	
dermatomycosis	dermatophytosis	
dermatomyositides	dermatomyositis	
dermatop	prednicarbate	
dermatopolymyositides	dermatopolymyositis	
dermatosclerosis	morphea	scleroderma	
deserpidine	harmonyl	
desflurane	suprane	
deslorelin	ovuplant	
desopan	modrenal	trilostane	
desoximetasone	desoxymetasone	desoxymethasone	topicort	
desoxyphenobarbital	hexamidinum	myidone	primidone	
dexamfetamine	dexamphetamine	dexedrine	dextroamphetamine	
dexmedetomidine	precedex	
dexpanthenol	ilopan	
dextromethmorphan	dextromethorphan	
dextropropoxyphene	propoxyphene	
dextrose	glucose	
diacetylmorphine	diamorphine	heroin	junk	skag	smack	
diagnoses	diagnosis	
dialyses	dialysis	
diarrhea	diarrhoea	dysentery	
diatheses	diathesis	
diazepam	valium	
diazoxide	proglycem	
dibromomannitol	mitobronitol	myelobromol	
dibromopropamidine	dibrompropamidine	
dichloralantipyrine	dichloralphenazone	dichlorophenazone	dichlorphenazone	
dichlorophen	dichlorophene	
dichlorphenamide	diclofenamide	
dicrocoeliases	dicrocoeliasis	
dictyocauliases	dictyocauliasis	
dicyclomine	dicycloverine	
dienestrol	dienoestrol	
dientameba	dientamoeba	
dientamoebiases	dientamoebiasis	
diethyldithiocarbamate	imuthiol	
difenidol	diphenidol	
diflucan	fluconazole	
diflunisal	dolobid	flovacil	
digoxin	lanoxin	
dihydrocodeinone	hydrocodone	
dihydrohydroxycodeinone	oxycodone	
dihydromorphinone	hydromorphone	
dihydroxyphenylalanine	dopa	
diiodohydroxyquin	diiodohydroxyquinoline	diodoxyquinoline	iodoquinol	
dilor	diprophylline	dylix	dyphylline	lufyllin	neothylline	
dimenhydrinate	dramamine	
dimercaprol	dimercaptopropanol	dithioglycerol	
dimesna	tavocept	
dimethicone	simethicone	simeticone	
dimethoxymethane	methylal	
dimethylsulfoxide	dimethylsulphoxide	
dipentum	olsalazine	
diphacinone	diphenadione	
diphenylhydantoin	phenylhydantoin	phenytoin	
diphyllobothriases	diphyllobothriasis	
dipipanone	phenylpiperone	
dipivefrin	dipivefrine	
diprazinum	promethazine	
diprivan	propofol	
dipyridamole	persantine	
dirithromycin	dynabac	
dirofilariases	dirofilariasis	
disalcid	salsalate	
discitides	discitis	
discolyses	discolysis	
diskitides	diskitis	
diucardin	hydroflumethiazide	saluron	
diulo	metenix	metolazone	mykrox	xuret	zaroxolyn	
diureses	diuresis	
diverticulitides	diverticulitis	
dofetilide	tikosyn	
domperidone	motilium	
dopamine	hydroxytyramine	
doral	quazepam	
doridamina	lonidamine	
dormutil	methaqualone	motolon	quaalude	somnafac	somnomed	
dosulepin	dothiepin	
doxercalciferol	hectorol	
dracunculiases	dracunculiasis	
dracunculoses	dracunculosis	
dromostanolone	drostanolone	
dronabinol	marinol	tetrahydrocannabinol	
droperidol	inapsine	
dropsy	edema	oedema	
drowsiness	drowsy	
droxia	hydrea	hydroxycarbamide	hydroxyurea	litalir	oncocarbide	oxeron	syrea	
drugs	medications	medicines	
dthyd	thymidine	
duragesic	fentanyl	
durapatite	hydroxyapatite	
dynacirc	isradipine	
dyrenium	triamterene	
dysarthoses	dysarthosis	
dyschondroplasia	enchondromatoses	enchondromatosis	
dysmenorrhea	dysmenorrhoea	
dyspepsia	indigestion	
dyspnea	dyspnoea	
dysthymia	neurasthenia	
earache	otalgia	
echinococcoses	echinococcosis	
echinostomiases	echinostomiasis	
echocardiogram	echocardiography	
ectogeneses	ectogenesis	
edematous	oedematous	
education	teaching	
eformoterol	formoterol	
ehrlichioses	ehrlichiosis	
elaeophoriases	elaeophoriasis	
electrodiagnoses	electrodiagnosis	
electroencephalogram	electroencephalography	
electrolyses	electrolysis	
electronarcoses	electronarcosis	
electrophoreses	electrophoresis	
elephantiases	elephantiasis	
elixophyllin	labid	respbid	theochron	theophylline	uniphyl	
elobromol	mitolac	mitolactol	
embolisation	embolization	
emesis	vomiting	
encephalitozoonoses	encephalitozoonosis	
encephalomeningitides	encephalomeningitis	
endarteritides	endarteritis	
endo	endometrioses	endometriosis	
endocarditides	endocarditis	
endocytoses	endocytosis	
endomycopses	endomycopsis	
endopeptidase	endopeptidases	protease	proteinase	
endophthalmitides	endophthalmitis	
enflurane	ethrane	
enhexymal	hexobarbital	hexobarbitone	methexenyl	methylhexabital	
enoximone	fenoximone	
entameba	entamoeba	
entamoebiases	entamoebiasis	
enteritides	enteritis	
enterobiases	enterobiasis	oxyuriases	oxyuriasis	pinworms	
enterocele	hernia	
enterocolitides	enterocolitis	
eperythrozoonoses	eperythrozoonosis	
ephelides	ephelis	
epidermophytoses	epidermophytosis	
epididymitides	epididymitis	
epiglottitides	epiglottitis	
epikeratophakia	epikeratoplasty	
epimenorrhea	epimenorrhoea	
epiphysiolyses	epiphysiolysis	
episcleritides	episcleritis	
epistaxis	nosebleeds	
epodyl	etoglucid	
epoprostenol	prostacyclin	
eptastatin	pravastatin	
equanil	meprobamate	miltown	
ergometrine	ergonovine	
eruption	exanthem	rash	
eryderm	erythromycin	ilotycin	robimycin	
erythraemia	erythremia	
erythroleukaemia	erythroleukemia	
erythropoieses	erythropoiesis	
eserine	physostigmine	
esophagectomy	oesophagectomy	
esophagitides	esophagitis	oesophagitis	
esophagogastrectomy	oesophagogastrectomy	
esophagogastroduodenoscopy	oesophagogastroduodenoscopy	
esophagogastroscopy	oesophagogastroscopy	
esophagogastrostomy	oesophagogastrostomy	
esophagojejunostomy	oesophagojejunostomy	
esophagomyotomy	oesophagomyotomy	
esophagoscopy	oesophagoscopy	
esophagospasm	oesophagospasm	
esophagostomiasis	oesophagostomiases	oesophagostomiasis	
esophagostomy	oesophagostomy	
esophagus	oesophagus	
estazolam	prosom	
estradiol	oestradiol	
estriol	oestriol	
estrogen	estrogens	oestrogen	oestrogens	
estrone	oestrone	
estropipate	ogen	
estrus	oestrus	
ethambutol	ethambutolol	
ethinylestradiol	ethinyloestradiol	
ethionamide	ethioniamide	
ethopropazine	profenamine	
ethosuximide	zarontin	
ethotoin	ethylphenylhydantoin	peganone	
ethylestrenol	ethyloestrenol	
ethylnorgestrienone	gestrinone	
ethynodiol	etynodiol	
etnogestrel	etonogestrel	
etodolac	lodine	
etoposide	lastet	vepesid	
etrenol	hycanthone	
etretinate	tegison	tigason	
eutelegeneses	eutelegenesis	
exophthalmos	proptoses	proptosis	
eyeglasses	spectacles	
faeces	feces	
fainting	syncope	
famotidine	pepcid	
farcy	glanders	
fasciitides	fasciitis	
fascioliases	fascioliasis	
fascioloidiases	fascioloidiasis	
fasciolopses	fasciolopsis	
fasciolopsiases	fasciolopsiasis	
fascitides	fascitis	
fasigyn	tindamax	tinidazole	
fasinex	triclabendazole	
fatigue	tiredness	
fecalith	scybalum	
felbamate	felbatol	
feldene	piroxicam	
felodipine	plendil	
feminisation	feminization	
fenofibrate	tricor	
fertiliser	fertilizer	
fetus	foetus	
fever	pyrexia	
fiberglass	fibreglass	
fibrinase	fibrinolysin	plasmin	
fibrinogenase	thrombin	
fibrinolyses	fibrinolysis	
fibroid	leiomyoma	
fibromatoses	fibromatosis	
fibromyalgia	fibromyositis	
fibroses	fibrosis	
fibrositides	fibrositis	
filariases	filariasis	
fimbriae	fimbrium	
finasteride	finastid	propecia	propeshia	proscar	prostide	urprosan	
flocofil	ismipur	leukerin	mercaleukim	mercaptina	mercaptopurine	mercaptopurinum	purinethiol	purinethol	
floxacillin	flucloxacillin	
floxuridine	fluorodeoxyuridine	fudr	
flu	influenza	
flumazenil	romazicon	
flumetasone	flumethasone	
fluocinonide	lidex	
fluoromethalone	fluorometholone	
fluorotrichloromethane	trichlorofluoromethane	trichloromonfluoromethane	trichloromonofluoromethane	
fluostigmin	isoflurophate	
fluoxymesterone	halodrin	halotestin	oratestin	stenox	testoral	ultandren	
flupenthixol	flupentixol	
flurothyl	indoklon	
folliculitides	folliculitis	
forebrain	prosencephalon	
formestane	lentaron	
fotemustine	muphoran	
frambesia	framboesia	
fructosaemia	fructosemia	
fructose	laevulose	levulose	
frusemide	furosemide	lasix	
fungaemia	fungemia	
fungarest	fungoral	ketoconazole	ketoderm	ketoisdin	nizoral	panfungol	xolegel	
fungi	fungus	molds	
fungicides	herbicides	pesticides	rodenticides	
furazosin	prazosin	
furunculoses	furunculosis	
gabapentin	neurontin	
gadodiamide	omniscan	
gadoteridol	prohance	
galactocele	lactocele	
galactosaemia	galactosemia	
gametogeneses	gametogenesis	
gammahexachlorocyclohexane	hexachlorocyclohexane	lindane	
ganja	grass	hash	herb	marijuana	poaceae	pot	weed	
garamicin	garamycin	genoptic	gentamicin	
gargle	mouthwash	
gastritides	gastritis	
gastroenteritides	gastroenteritis	
gastropareses	gastroparesis	
gemcitabine	gemzar	
gemfibrozil	lopid	
geotrichoses	geotrichosis	
gestronol	gestronorone	
giardiases	giardiasis	
gingivitides	gingivitis	
gingivoses	gingivosis	
girostan	ledertepa	oncotiotepa	tespamin	tespamine	thiofozil	thioplex	thiotef	thiotepa	tifosyl	triethylenethiophosphoramide	
glauctabs	methazolamide	neptazane	
glibenclamide	glybenclamide	glybenzcyclamide	glyburide	micronase	
gliclazide	glyclizide	
glioses	gliosis	
glipizide	glucotrol	glydiazinamide	
gln	glutacerebro	glutamine	glutaven	levoglutamide	memoril	
glomerulonephritides	glomerulonephritis	
glossitides	glossitis	
glucarpidase	voraxaze	
glucosamine	glycosamine	
glutaral	glutaraldehyde	glutardialdehyde	
gly	glycine	
glycerin	glycerine	glycerol	
glycogenoses	glycogenosis	
glycopyrrolate	glycopyrronium	robinul	
glycyrrhiza	licorice	liquorice	
glyset	miglitol	
goiter	goitre	
gonorrhea	gonorrhoea	
guaianesin	guaifenesin	humibid	mucinex	
gynaecology	gynecology	
gynaecomastia	gynecomastia	
gynaecomazia	gynecomazia	
habronemiases	habronemiasis	
haemagglutination	hemagglutination	
haemangioendothelioma	hemangioendothelioma	
haemangioma	hemangioma	
haemangiopericytoma	hemangiopericytoma	
haemangiosarcoma	hemangiosarcoma	
haemarthrosis	hemarthroses	hemarthrosis	
haematemesis	hematemeses	hematemesis	
haematinic	hematinic	
haematocele	haematocoele	hematocele	
haematocolpos	hematocolpos	
haematometra	hematometra	
haematomyelia	hematomyelia	
haematosalpinx	hematosalpinx	
haematospermia	haemospermia	hematospermia	hemospermia	
haematuria	hematuria	
haemin	hemin	
haemobartonelloses	haemobartonellosis	
haemochromatosis	hemochromatoses	hemochromatosis	
haemodialysis	hemodialyses	hemodialysis	
haemofiltration	hemofiltration	
haemoglobin	hemoglobin	
haemoglobinopathies	hemoglobinopathies	
haemoglobinopathy	hemoglobinopathy	
haemoglobinuria	hemoglobinuria	
haemolysis	hemolysis	
haemonchiases	haemonchiasis	
haemoperfusion	hemoperfusion	
haemopericardium	hemopericardium	
haemoperitoneum	hemoperitoneum	
haemopexin	hemopexin	
haemophilus	hemophilus	
haemophthalmos	hemophthalmos	
haemopneumothorax	hemopneumothorax	pneumohemothorax	
haemopoiesis	hematopoiesis	hemopoiesis	
haemoptysis	hemoptyses	hemoptysis	
haemorrhoid	hemorrhoid	
haemorrhoidectomy	hemorrhoidectomy	
haemorrhoids	hemorrhoids	piles	
haemosiderosis	hemosideroses	hemosiderosis	
haemostatic	hemostatic	
haemostyptic	hemostyptic	
haemothorax	hemothorax	
haemotympanum	hematotympanum	hemotympanum	
halazepam	paxipam	
halcinonide	halog	
haldol	haloperidol	
halitoses	halitosis	
haptene	haptens	haptin	
heartburn	pyroses	pyrosis	waterbrash	
helminthiases	helminthiasis	
hematoporphyrinuria	porphyrinuria	porphyruria	
hemianopia	hemianopsia	
hemipareses	hemiparesis	
hemiplegia	paralysis	paraplegia	quadriplegia	
hemostases	hemostasis	
hepatitides	hepatitis	
hespan	hetastarch	
hexachloroethane	perchloroethane	
hexachlorophane	hexachlorophene	phisohex	septisol	
hexamethylenetetramine	hexamine	methenamine	
hiccough	hiccup	
hiccoughs	hiccups	
hidradenitides	hidradenitis	
hidradenoma	syringoadenoma	
hidrosadenitides	hidrosadenitis	
his	histidine	
histiocytoses	histiocytosis	
histomoniases	histomoniasis	
histoplasmoses	histoplasmosis	
hives	urticaria	wheal	
hoarse	hoarseness	
holoxan	holoxane	ifex	ifolem	ifomida	ifosfamide	ifosfamidum	ifoxan	mitoxana	seromida	tronoxal	
hospitalisation	hospitalization	
hyaluronidase	hyaluronoglucosaminidase	
hydatidoses	hydatidosis	
hydradenitides	hydradenitis	
hydrochlorothiazide	hydrodiuril	
hydronephroses	hydronephrosis	
hydrophobia	rabies	
hydroquinol	hydroquinone	quinol	
hydroxybenzene	oxybenzene	phenol	
hydroxyethylcellose	hydroxyethylcellulose	hyetellose	
hydroxymesterone	medrysone	
hydroxyphenylbutazone	oxyphenbutazone	
hydroxypropylcellulose	klucel	
hydroxypropylmethylcellulose	hypromellose	
hymenolepiases	hymenolepiasis	
hyoscine	scopolamine	
hyperacuses	hyperacusis	
hyperaemia	hyperemia	
hyperaesthesia	hyperesthesia	
hyperalgesia	hyperpathia	
hyperapobetalipoproteinaemia	hyperapobetalipoproteinemia	
hyperbetalipoproteinaemia	hyperbetalipoproteinemia	
hyperbilirubinaemia	hyperbilirubinemia	
hypercalcaemia	hypercalcemia	
hypercalciuria	hypercalcuria	
hypercementoses	hypercementosis	
hyperchloraemia	hyperchloremia	
hyperchylomicronaemia	hyperchylomicronemia	
hyperestrogenism	hyperoestrogenism	
hypergammaglobulinaemia	hypergammaglobulinemia	
hyperglycaemia	hyperglycemia	
hyperinsulinaemia	hyperinsulinemia	
hyperkalaemia	hyperkalemia	
hypermagnesaemia	hypermagnesemia	
hypermelanoses	hypermelanosis	
hypermenorrhea	hypermenorrhoea	
hypernatraemia	hypernatremia	
hyperostoses	hyperostosis	
hyperphosphataemia	hyperphosphatemia	
hyperprolactinaemia	hyperprolactinemia	
hypertrichoses	hypertrichosis	
hypertriglyceridaemia	hypertriglyceridemia	
hypesthesia	numbness	
hyphaema	hyphema	
hypnoses	hypnosis	
hypoaesthesia	hypoesthesia	
hypocalcaemia	hypocalcemia	
hypochloraemia	hypochloremia	
hypodermyiases	hypodermyiasis	
hypogammaglobulinaemia	hypogammaglobulinemia	
hypoglycaemia	hypoglycemia	
hypokalaemia	hypokalemia	
hypomagnesaemia	hypomagnesemia	
hypomelanoses	hypomelanosis	
hypomenorrhea	hypomenorrhoea	
hyponatraemia	hyponatremia	
hypophosphataemia	hypophosphatemia	
hypophyses	hypophysis	
hypopotassaemia	hypopotassemia	
hypoproteinaemia	hypoproteinemia	
hypotrichoses	hypotrichosis	
hysterosalpingogram	hysterosalpingography	
ibenzmethyzin	procarbazine	
ibuprofen	motrin	
icebox	refrigerator	
ichthyoses	ichthyosis	
icterus	jaundice	
ile	isoleucine	
imipemide	imipenem	
immobilisation	immobilization	
immunisation	immunization	vaccination	
immunisations	immunizations	
immunodiagnoses	immunodiagnosis	
immunosuppressant	immunosuppressive	
immunosuppression	immunosupression	
indapamide	lozol	
indocin	indometacin	indomethacin	
infertility	sterility	
inflammation	inflammatory	
inose	inositol	
interphase	karyostasis	
intracellular	protoplasm	
iodamoebiases	iodamoebiasis	
iodine	jodum	
iofendylate	iophendylate	
iontopheresis	iontophoreses	iontophoresis	
iopamidol	isovue	
iopodate	ipodate	
iopromide	ultravist	
ipecac	ipecacuanha	
iridocyclitides	iridocyclitis	
iritides	iritis	
islam	moslem	
isocarboxazid	marplan	
isoetarine	isoetharine	
isoethadione	paramethad	paramethadione	
isogel	ispaghula	metamucil	psyllium	
isoniazid	isonicotinylhydrazide	
isoprenaline	isoproterenol	isoproteronol	
isotachophoreses	isotachophoresis	
isovorin	leucovorin	levoleucovorin	
itching	pruritis	
itraconazole	sporanox	
ivermectin	stromectol	
ixoten	trofosfamide	
kazakhistan	kazakhstan	
keratitides	keratitis	
keratoconjunctivitides	keratoconjunctivitis	
keratoses	keratosis	
ketanserin	ketensin	serefrex	sufrexal	
ketoprofen	orudis	oruvail	
kidnaping	kidnapping	
kinase	phosphotransferase	
kineses	kinesis	
kinestheses	kinesthesis	
kinevac	sincalide	
kirghizstan	kyrgyzstan	
kyphoses	kyphosis	
labor	labour	
labyrinthitides	labyrinthitis	
lactase	tilactase	
laevocardia	levocardia	
lagothrices	lagothrix	
lambliases	lambliasis	
lamictal	lamotrigine	
lampit	nifurtimox	
lansoprazole	prevacid	
lanvis	thioguanine	tioguanin	tioguanine	
laryngitides	laryngitis	
laryngopharyngitis	pharyngolaryngitis	
laryngostenoses	laryngostenosis	
latanoprost	xalatan	
lead	pb	
lecithin	phosphatidylcholine	
legionelloses	legionellosis	
leishmaniases	leishmaniasis	
lentiginoses	lentiginosis	
leptospiroses	leptospirosis	
leu	leucine	
leucocoria	leukocoria	
leucorrhoea	leukorrhagia	leukorrhea	leukorrhoea	
leukaemia	leukemia	
leukaemias	leukemias	
leukaphereses	leukapheresis	
leukocytaphereses	leukocytapheresis	
leukocytophereses	leukocytopheresis	
leukocytoses	leukocytosis	
leukophereses	leukopheresis	
leuprolide	leuprorelin	
levarterenol	noradrenaline	norepinephrine	
levonorgestrel	norplant	
levothyroxine	thyroxine	
liarozole	liazal	
linamarin	phaseolunatin	
liothyronine	triiodothyronine	
lipase	tributyrase	
lipolyses	lipolysis	
lipomatoses	lipomatosis	
lipomucopolysaccharidoses	lipomucopolysaccharidosis	
lisinopril	prinivil	zestril	
lisodren	lysodren	mitotane	
lisuride	lysuride	
lithiases	lithiasis	
livial	tibolone	
loaiases	loaiasis	
lockjaw	tetanus	
loiases	loiasis	
loprazolam	triazulenone	
losec	omeprazole	prilosec	
lovastatin	mevacor	mevinolin	
luteine	progesterone	progestogen	
lymphadenitides	lymphadenitis	
lymphangiectases	lymphangiectasis	
lymphangiogram	lymphangiography	
lymphangitides	lymphangitis	
lymphaphereses	lymphapheresis	
lymphedema	lymphoedema	
lymphocytaphereses	lymphocytapheresis	
lymphocytopenia	lymphopenia	
lymphocytophereses	lymphocytopheresis	
lymphocytoses	lymphocytosis	
lymphophereses	lymphopheresis	
lynestrenol	lynoestrenol	
lys	lysine	
macao	macau	
macrobid	macrodantin	nitrofurantoin	
macroglobulinaemia	macroglobulinemia	
magnesium	mg	
mairungi	mairungus	
malathion	ovide	
mammogram	mammography	
man	men	
manganese	mn	
mannitol	osmitrol	resectisol	
mansonelliases	mansonelliasis	
marriage	married	
marsupialisation	marsupialization	
mastocytoses	mastocytosis	
mastoiditides	mastoiditis	
mavik	trandolapril	trolandapril	
measles	rubeola	
mebendazole	vermox	
meccnu	semustine	
meclizine	meclozine	
mecobalamin	methylcobalamin	
mecysteine	methylcysteine	
mediastinitides	mediastinitis	
medigoxin	metildigoxin	
megaesophagus	megaoesophagus	
megag	mitoguazone	zyrkamine	
meioses	meiosis	
melaena	melena	
melanoses	melanosis	
melioidoses	melioidosis	
melorheostoses	melorheostosis	
meloxicam	mobec	mobic	mobicox	movalis	
melphalan	melphalanum	sarcolysin	sarkolysin	
meninges	meninx	
meningism	meningismus	
meningitides	meningitis	
meningoencephalitides	meningoencephalitis	
menogaril	menogarol	
menses	menstruation	period	
mepacrine	quinacrine	
mepentil	sintomodulina	thymopentin	timunox	
meperidine	pethidine	
mephenytoin	methoin	methylphenylethylhydantoin	
mephobarbital	methylphenobarbital	methylphenobarbitone	
mepyramine	pyrilamine	
mercaptopropionylglycine	thiola	thiopronine	tiopronin	
meridia	sibutramine	
met	methionine	
metacycline	methacycline	
metagonimiases	metagonimiasis	
metahydrin	naqua	trichlormethiazide	
metandienone	methandienone	methandrostenolone	
metaproterenol	orciprenaline	
metastases	metastasis	
metaxalone	skelaxin	
methaemalbumin	methemalbumin	
methaemoglobin	methemoglobin	
methaemoglobinaemia	methemoglobinemia	
methantheline	methanthelinium	
methapyrilene	thenylpyramine	
methazolastone	temodal	temodar	temozolomide	
methimazole	tapazole	thiamazole	
methocarbamol	robaxin	
methohexital	methohexitone	
methylergometrine	methylergonovine	
methyprylon	methyprylone	
metopirone	metyrapone	
metrifonate	trichlorfon	
mezlin	mezlocillin	
micoren	prethcamide	
micrencephaly	microcephalus	microcephaly	
microphthalmia	microphthalmos	
microsporidioses	microsporidiosis	
microvilli	microvillus	
micturition	urination	
mifegyne	mifeprex	mifepristone	
miltefosine	miltex	
minoxidil	rogaine	
mintezol	thiabendazole	thibenzole	tiabendazole	
mioses	miosis	
mirtazapine	remeron	
mith	mithracin	mithracine	mithramycin	plicamycin	
mitochondria	mitochondrion	
mitoses	mitosis	
mitoxantrone	mitozantrone	
mo	molybdenum	
mobilising	mobilizing	
modafinil	provigil	
moderil	rescinnamine	
moldavia	moldova	
moles	naevus	nevus	
monieziases	monieziasis	
moniliases	moniliasis	
monoctanoin	monooctanoin	octanoin	
mopidamol	rapenton	
moracizine	moricizine	
morpholinylmercaptobenzothiazo	morpholinylmercaptobenzothiazole	
moxalactam	moxam	
moxisylyte	thymoxamine	
mucormycoses	mucormycosis	
muscimol	pantherine	
mutageneses	mutagenesis	
mycobutin	rifabutin	
mycoses	mycosis	
mycostatin	nystatin	nystex	
mycotoxicoses	mycotoxicosis	
myelitides	myelitis	
myeloencephalitides	myeloencephalitis	
myelofibroses	myelofibrosis	
myelogram	myelography	
myeloscleroses	myelosclerosis	
myelosyringoses	myelosyringosis	
myiases	myiasis	
myocarditides	myocarditis	
myositides	myositis	
myringotomy	tympanotomy	
myxedema	myxoedema	
na	sodium	
nabumetone	relafen	
naevoxanthoendothelioma	nevoxanthoendothelioma	
nafronyl	naftidrofuryl	
naltrexone	vivitrol	
naprosyn	naproxen	
narcosyntheses	narcosynthesis	
nardil	phenelzine	
nasopharyngitides	nasopharyngitis	
natamycin	pimaricin	
natrecor	nesiritide	
natriureses	natriuresis	
navoban	tropisetron	
nebuliser	nebulizer	
necatoriases	necatoriasis	
necrobacilloses	necrobacillosis	
necrobioses	necrobiosis	
necroses	necrosis	necrotic	
neighborhood	neighbourhood	
neocortex	neocortices	
neogest	norgestrel	ovrette	
nephritides	nephritis	
nephrocalcinoses	nephrocalcinosis	
nephroscleroses	nephrosclerosis	
nephroses	nephrosis	
neurilemma	neurolemma	
neurilemmoma	neurilemoma	schwannoma	
neuritides	neuritis	
neurodermatitides	neurodermatitis	
neurolymphomatoses	neurolymphomatosis	
neuron	neurone	
neuropsychopharmacology	psychopharmacology	
neuroretinoangiomatoses	neuroretinoangiomatosis	
neutrophilia	nnutrophilia	
nevirapine	viramune	
niacinamide	nicamid	nicosedine	nicotinamide	
nidran	nimustine	
nimodipine	nimotop	
nisoldipine	sular	
nitisinone	orfadin	
nitramine	tetranitromethylaniline	
nitrofural	nitrofurazone	
nitroglycerin	nitroglycerine	nitroglycerol	
norethynodrel	noretynodrel	
norfloxacin	noroxin	
nortriptyline	nortryptyline	
noxythiolin	noxytiolin	
ochronoses	ochronosis	
octastatin	vapreotide	
octoxinol	octoxynol	
oculomycoses	oculomycosis	
odontogeneses	odontogenesis	odontogeny	odontosis	
olanzapine	zyprexa	
oligomenorrhea	oligomenorrhoea	
oncaspar	pegaspargase	
onchocerciases	onchocerciasis	
onconase	ranpirnase	
onycholyses	onycholysis	
onychomycoses	onychomycosis	
oogeneses	oogenesis	
oophoritides	oophoritis	
opisthorchiases	opisthorchiasis	
optician	optometrist	
orap	pimozide	
orchidopexy	orchiopexy	
orchitides	orchitis	
orlistat	xenical	
ornithoses	ornithosis	psittacoses	psittacosis	
orthopnea	orthopnoea	
osmoses	osmosis	
ossification	osteogenesis	
osteoarthritides	osteoarthritis	osteoarthroses	osteoarthrosis	
osteochondritides	osteochondritis	
osteochondroses	osteochondrosis	
osteolyses	osteolysis	
osteomyelitides	osteomyelitis	
osteonecroses	osteonecrosis	
osteopetroses	osteopetrosis	
osteopoikiloses	osteopoikilosis	
osteoporoses	osteoporosis	
osteoradionecroses	osteoradionecrosis	
osteoscleroses	osteosclerosis	
ostertagiases	ostertagiasis	
otitides	otitis	
otorrhea	otorrhoea	
otoscleroses	otosclerosis	
otospongioses	otospongiosis	
ovastat	treosulfan	treosulphan	
oxandrin	oxandrolone	
oxazepam	serax	
oxcarbazepine	trileptal	
oxpentifylline	pentoxifylline	pentoxyphylline	trental	
oxyhaemoglobin	oxyhemoglobin	
oxyquinol	oxyquinoline	
ozaena	ozena	
pachydermoperiostoses	pachydermoperiostosis	
pachymeningitides	pachymeningitis	
paedophilia	pedophilia	
pancreatitides	pancreatitis	
panniculitides	panniculitis	
panophthalmitides	panophthalmitis	
papilledema	papilloedema	
parabioses	parabiosis	
paracenteses	paracentesis	
paracetaldehyde	paraldehyde	
parachuting	parachutist	
paracoccidioidomycoses	paracoccidioidomycosis	
paraesthesia	paresthesia	
paragonimiases	paragonimiasis	
parakeratoses	parakeratosis	
parametritides	parametritis	
paraphimoses	paraphimosis	
paraproteinaemia	paraproteinemia	
parapsoriases	parapsoriasis	
paratetrafluoroethylene	polytetrafluoroethylene	
paratuberculoses	paratuberculosis	
paravaccinia	pseudocowpox	
pareses	paresis	
parnate	tranylcypromine	
parodontoses	parodontosis	
parotiditides	parotiditis	
parotitides	parotitis	
parthenogeneses	parthenogenesis	
pasteurelloses	pasteurellosis	
pediculoses	pediculosis	
pentobarbital	pentobarbitone	
pentylenetetrazol	pentylenetetrazole	
people	person	
perfosfamide	pergamid	
periarthritides	periarthritis	
pericardiocenteses	pericardiocentesis	
pericarditides	pericarditis	
pericementitides	pericementitis	
periciazine	pericyazine	propericiazine	
pericoronitides	pericoronitis	
perinephritides	perinephritis	
periodontitides	periodontitis	
periostitides	periostitis	
periphlebitides	periphlebitis	
peristalses	peristalsis	
perspiration	perspirationsubstance	sweat	
pertusses	pertussis	
phaeochromocytoma	pheochromocytoma	
phagocytoses	phagocytosis	
pharyngitides	pharyngitis	
phe	phenylalanine	
phenacemide	phenylacetylcarbamide	phenylacetylurea	
phenethylbiguanide	phenformin	
phenobarbital	phenobarbitone	phenylethylmalonylurea	
phenolsulfonphthalein	phenolsulphonphthalein	
phereses	pheresis	
phimoses	phimosis	
phlebitides	phlebitis	thrombophlebitides	thrombophlebitis	
phlebolith	phlebolithiasis	
phlebothromboses	phlebothrombosis	
phonophoreses	phonophoresis	
photodermatitides	photodermatitis	
phthalylsulfathiazole	phthalylsulphathiazole	
phycomycosis	zygomycoses	zygomycosis	
pindolol	prindolol	prinodolol	visken	
pinocytoses	pinocytosis	
pinorubicin	pirarubicin	theprubicin	theprubicine	therarubicin	
pipobroman	vercyte	
pipothiazine	pipotiazine	
piroplasmoses	piroplasmosis	
pityriases	pityriasis	
pivaloyloxymethylbutyrate	pivanex	
pizotifen	pizotyline	
plasmaphereses	plasmapheresis	
plateletphereses	plateletpheresis	
pleocytoses	pleocytosis	
pleuritides	pleuritis	
pneumencephalography	pneumoencephalography	
pneumoconioses	pneumoconiosis	
pneumocystoses	pneumocystosis	
pneumonitides	pneumonitis	
pneumonolyses	pneumonolysis	
podofilox	podophyllotoxin	
pollinoses	pollinosis	
polyarthritides	polyarthritis	
polycythaemia	polycythemia	
polymenorrhea	polymenorrhoea	
polymyositides	polymyositis	
polyneuritides	polyneuritis	
polyribosome	polysome	
polythiazide	renese	
polyvinylpyrrolidone	povidone	
porfiromycin	promycin	
potential	risk	
pramocaine	pramoxine	
prednimustine	sterecyt	stereocyt	
presbyacusis	presbycuses	presbycusis	
prilocaine	propitocaine	
pro	proline	
proctitides	proctitis	
prognoses	prognosis	
prograf	protopic	tacrolimus	
proloprim	trimethoprim	trimpex	
proparacaine	proxymetacaine	
prostatitides	prostatitis	
prostheses	prosthesis	
protirelin	thypinone	
protriptyline	protryptyline	
proxyphylline	theon	
prulaurasin	prunasin	
pseudarthroses	pseudarthrosis	pseudoarthroses	pseudoarthrosis	
pseudomeningitides	pseudomeningitis	
pseudopapilledema	pseudopapilloedema	
pseudopod	pseudopodium	
psilocybin	psilocybine	
psoriases	psoriasis	
psychoanalyses	psychoanalysis	
pulpitides	pulpitis	
pyelonephritides	pyelonephritis	
pygathrices	pygathrix	
quinalbarbitone	secobarbital	
rachitis	rickets	
radiculitides	radiculitis	
radiodermatitides	radiodermatitis	
raillietiniases	raillietiniasis	
rapamune	rapamycin	sirolimus	
razoxane	razoxin	
rebetol	ribavirin	tribavirin	virazid	virazole	
rectocele	rectocoele	
rehab	rehabilitation	
resorcin	resorcinol	
retinoschises	retinoschisis	
rhabditides	rhabditis	
rhabdomyolyses	rhabdomyolysis	
rhinitides	rhinitis	
rhinosporidioses	rhinosporidiosis	
rhonchi	rhonchus	
riboflavin	riboflavine	
riboxamide	tiazofurin	
rifadin	rifampicin	rifampin	rimactane	
rifaximin	xifaxan	
rigid	rigidity	
rilutek	riluzole	
rimexolone	vexol	
rodex	warfarin	
roxithromycin	rulide	
rutin	rutoside	
ryania	ryanodine	
saccharomycopses	saccharomycopsis	
saimiri	saimirus	
salmonelloses	salmonellosis	
salpingitides	salpingitis	
saltpeter	saltpetre	
sarcocystoses	sarcocystosis	
sarcoidoses	sarcoidosis	
sarcosporidioses	sarcosporidiosis	
saucerisation	saucerization	
schistosomiases	schistosomiasis	
sciatia	sciatica	
scleritides	scleritis	
scleroses	sclerosis	
scolioses	scoliosis	
se	selenium	
seborrhea	seborrhoea	
seldane	teldane	terfenadine	
septicaemia	septicemia	
ser	serine	
serositides	serositis	
setariases	setariasis	
sevoflurane	ultane	
sialadenitides	sialadenitis	
sialitides	sialitis	
sialorrhea	sialorrhoea	
sideroses	siderosis	
silicoses	silicosis	
silicotuberculoses	silicotuberculosis	
simvastatin	synvinolin	velastatin	zocor	
sinusitides	sinusitis	
sn	tin	
sneezes	sneezing	
socialisation	socialisingact	socialization	
somatotrophin	somatropin	
sonogram	ultrasound	
spandex	spandices	
sparfloxacin	zagam	
sparganoses	sparganosis	
spondylistheses	spondylisthesis	
spondylitides	spondylitis	
spondylodiscitides	spondylodiscitis	
spondylodiskitides	spondylodiskitis	
spondylolistheses	spondylolisthesis	spondylolithesis	
spondylolyses	spondylolysis	
sporothrices	sporothrix	
sporotrichoses	sporotrichosis	
stafac	virginiamycin	
stammering	stuttering	
stavudine	zerit	
steatitides	steatitis	
steatonecroses	steatonecrosis	
steatorrhea	steatorrhoea	
stereognoses	stereognosis	
stereopses	stereopsis	
steritalc	talc	talcum	
stomatitides	stomatitis	
streptozocin	streptozotocin	zanosar	
strongyloidiases	strongyloidiasis	
succinylcholine	suxamethonium	
sulfacetamide	sulphacetamide	
sulfadiazine	sulphadiazine	
sulfadimethoxine	sulphadimethoxine	
sulfadimidine	sulfamethazine	sulphadimidine	
sulfadoxine	sulphadoxine	
sulfaemoglobin	sulphaemoglobin	
sulfafurazole	sulfisoxazole	sulphafurazole	sulphisoxazole	
sulfaguanidine	sulphaguanidine	
sulfalene	sulfametopyrazine	sulphametopyrazine	
sulfamerazine	sulphamerazine	
sulfamethizole	sulphamethizole	thiosulfil	
sulfamethoxazole	sulphamethoxazole	
sulfanilamide	sulphanilamide	sultrin	trysul	
sulfapyridine	sulphapyridine	
sulfate	sulphate	
sulfates	sulphates	
sulfathiazole	sulphathiazole	
sulfaurea	sulphaurea	
sulfemoglobin	sulfhemoglobin	
sulfemoglobinemia	sulfhemoglobinemia	
sulfite	sulphite	
sulfonamide	sulphonamide	
sulfonylurea	sulphonylurea	
sulfur	sulphur	
suprofen	sutoprofen	
sycoses	sycosis	
symbioses	symbiosis	
symphalangism	syndactyly	
syngamiases	syngamiasis	
synostoses	synostosis	
synovitides	synovitis	
tadzhikistan	tajikistan	
taenia	tenia	
taeniases	taeniasis	teniasis	
targocid	teicoplanin	
taurolidine	taurolin	
telangiectases	telangiectasia	telangiectasis	
temacept	tribromsalan	tribromsalicylanilide	
tendinitides	tendinitis	tendonitides	tendonitis	
teniposide	vehem	vumon	
tenosynovitides	tenosynovitis	
terconazole	triaconazole	
teslac	testolactone	
tetrachlorethane	tetrachloroethane	
tetrahydrozoline	tetryzoline	
th	thallium	
thalassaemia	thalassemia	
tham	trometamol	tromethamine	
theileriases	theileriasis	
theilerioses	theileriosis	
thermoception	thermoreception	
thermogeneses	thermogenesis	
thesaurismoses	thesaurismosis	
thimerosal	thimerosol	thiomersal	
thiopental	thiopentone	
thiothixene	tiotixene	
thr	threonine	
thrombocytaphereses	thrombocytapheresis	
thrombocytopaenia	thrombocytopenia	
thrombocytophereses	thrombocytopheresis	
thromboses	thrombosis	
thymalfasin	zadaxin	
thyroiditides	thyroiditis	
thyrotoxicoses	thyrotoxicosis	
ticar	ticarcillin	
tocolyses	tocolysis	
tonsillitides	tonsillitis	
topamax	topiramate	
torasemide	torsemide	
toruloses	torulosis	
toxascariases	toxascariasis	
toxocariases	toxocariasis	
toxoplasmoses	toxoplasmosis	
tracheitides	tracheitis	
trembling	tremor	
triacetyloleandomycin	troleandomycin	
trichinelliases	trichinelliasis	
trichinelloses	trichinellosis	
trichinoses	trichinosis	
trichocephaliases	trichocephaliasis	
trichophytoses	trichophytosis	
trichostrongyloidiases	trichostrongyloidiasis	
trichostrongyloses	trichostrongylosis	
trichuriases	trichuriasis	
tridione	trimethadione	troxidone	
trientine	triethylenetetramine	
triethanolamine	trolamine	
trifluorothymidine	trifluridine	
trimetaphan	trimethaphan	
trioxsalen	trioxysalen	
trombiculiases	trombiculiasis	
trp	tryptophan	
trypanosomiases	trypanosomiasis	
tuberculoses	tuberculosis	
tularaemia	tularemia	
tumor	tumour	
turbatrices	turbatrix	
tyr	tyrosine	
unithiol	unitiol	
uraemia	uremia	
urd	uridine	
ureterocystostomy	ureteroneocystostomy	
ureterolithiases	ureterolithiasis	
urethritides	urethritis	
urethrorrhea	urethrorrhoea	
urethrovesicopexy	vesicourethropexy	
urinalyses	urinalysis	
uveitides	uveitis	
uveomeningoencephalitides	uveomeningoencephalitis	
uveoparotitides	uveoparotitis	
vaginitides	vaginitis	
val	valine	
valrubicin	valstar	valtaxin	
varicocele	varicocoele	
vascularisation	vascularization	
vascularised	vascularized	
vasodilatation	vasodilation	
verdoglobin	verdohemoglobin	
verruca	warts	
viraemia	viremia	
virilisation	virilization	
vitellogeneses	vitellogenesis	
vulvitides	vulvitis	
vulvovaginitides	vulvovaginitis	
woman	women	
xanthoma	xanthomatoses	xanthomatosis	
zileuton	zyflo	
zinc	zn	
zonegran	zonisamide	
